------------------------------------------------------------------------------------------------------------------------------------------------------------------------------------------------------------------------------------------------
------------------------------------------------------------------------------------------------------------------------------------------------------------------------------------------------------------------------------------------------
------------------------------------------------------------------------------------------------------------------------------------------------------------------------------------------------------------------------------------------------
------------------------------------------------------------------------------------------------------------------------------------------------------------------------------------------------------------------------------------------------
------------------------------------------------------------------------------------------------------------------------------------------------------------------------------------------------------------------------------------------------
------------------------------------------------------------------------------------------------------------------------------------------------------------------------------------------------------------------------------------------------
------------------------------------------------------------------------------------------------------------------------------------------------------------------------------------------------------------------------------------------------
---------------------------2---------------------------------------------------------111111111---1112---------------2-----------111----1221--------------------------------------------------------33--------W----------------------------------
--------------------------------------------------------111---------------------------------------------------------------------------------------------------------------------------------------333--------W----------------------------------
-------------------------------------------------------------------------------------------------------------------------------------------------------------------------------------------------3333--------W----------------------------------
------------------------------------------------------------------------------------------------------------------------------------------------------------------------------------------------33333--------W----------------------------------
---------------------2---12121---------------------AB---------AB------------------121----------------1-----11----2--1--2-----1----------11------3--3----------33--3------------1121------------333333--------W----------------------------------
-------------------------------------------AB------CD---------CD-------------------------------------------------------------------------------33--33--------333--33------------------AB------3333333--------W----------------------------------
---------------------------------AB--------CD------CD---------CD------------------------------------------------------------------------------333--333------3333--333-----AB----------CD-----33333333--------W----------------------------------
---------------------------------CD--------CD------CD---------CD-----------------------------------------------------------------------------3333--3333----33333--3333----CD----------CD----333333333--------3----------------------------------
44444444444444444444444444444444444444444444444444444444444444444444444449--544444444444449---544444444444444444444444444444444444444444444444449--5444444444449--544444444444444444444444444444444444444444444444444444444444444444444444444449
77777777777777777777777777777777777777777777777777777777777777777777777778--677777777777778---677777777777777777777777777777777777777777777777778--6777777777778--677777777777777777777777777777777777777777777777777777777777777777777777777778
77777777777777777777777777777777777777777777777777777777777777777777777778--677777777777778---677777777777777777777777777777777777777777777777778--6777777777778--677777777777777777777777777777777777777777777777777777777777777777777777777778
77777777777777777777777777777777777777777777777777777777777777777777777778--677777777777778---677777777777777777777777777777777777777777777777778--6777777777778--677777777777777777777777777777777777777777777777777777777777777777777777777778