--------------------------------------------------------------------------------------------------------------------------------------------------------------------------------------------------------------------------------------------------------------------
--------------------------------------------------------------------------------------------------------------------------------------------------------------------------------------------------------------------------------------------------------------------
--------------------------------------------------------------------------------------------------------------------------------------------------------------------------------------------------------------------------------------------------------------------
--------------------------------------------------------------------------------------------------------------------------------------------------------------------------------------------------------------------------------------------------------------------
--------------------------------------------------------------------------------------------------------------------------------------------------------------------------------------------------------------------------------------------------------------------
--------------------------------------------------------------------------------------------------------------------------------------------------------------------------------------------------------------------------------------------------------------------
--------------------------------------------------------------------------------------------------------------------------------------------------------------------------------------------------------------------------------------------------------------------
---------------------111111221111111111111-------------------------------------------111111111----------------------2-----------111----1221-------------------------------------------------------------33--------W-------------------------------------------------
---------------------1-------------------------------111-----------------------------------------------------------------------------------------------------------------------------------------------333--------W-------------------------------------------------
---------------------1-------------------------------------------------------------------------111----------------------------------------------------------------------------------------------------3333--------W-------------------------------------------------
----------------------------------------------------------------------------------------------------------------------------------------------------111----------------------------------------------33333--------W-------------------------------------------------
-------------------------12121---1111--11----------AB---------AB------------------121----------------1-----11----2--11--2-----1----------11-------------------------3--3------------1121------------333333--------W-------------------------------------------------
-------------------------1-------1111---1--AB------CD---222---CD----------------------------3-----------------------11--------------------------AB-----------------33--33------------------AB------3333333--------W-------------------------------------------------
---------------------1--11-----1-1111---1--CD--21--CD---------CD--------------------------3333----------------------11--------------------------CD---------------3333--333-----AB----------CD-----33333333--------W-------------------------------------------------
---------------------1---1-------1111---1--CD------CD---------CD------------------------33333-----------------------11--------------------------CD--------------33333--3333----CD----------CD----333333333--------3-------------------------------------------------
44444444444444444444444444444444444444444444444444444444444444444444444449----544444444444449------5444444444444444444444449---------------54444444444444444444444449--5444444444449--544444444444444444444444444444444444444444444444444444444444444444444444444449
77777777777777777777777777777777777777777777777777777777777777777777777778----677777777777778------6777777777777777777777778---------------67777777777777777777777778--6777777777778--677777777777777777777777777777777777777777777777777777777777777777777777777778
77777777777777777777777777777777777777777777777777777777777777777777777778----677777777777778------6777777777777777777777778---------------67777777777777777777777778--6777777777778--677777777777777777777777777777777777777777777777777777777777777777777777777778
77777777777777777777777777777777777777777777777777777777777777777777777778----677777777777778------6777777777777777777777778---------------67777777777777777777777778--6777777777778--677777777777777777777777777777777777777777777777777777777777777777777777777778